[
    b"1111111111345671723456717234567172345671723456717234567172345671",
    b"1000000000000002700000000000000270000000000000027000000000000002",
    b"1000090000000003600000000000000360000000000000036000000000000003",
    b"1000550000000004500000000000000450000000000000045000000000000004",
    b"1000553000000030000000300000003540000030000000300000003000000035",
    b"1000554:::::::40000000400000004000000040000000400000004000000046",
    b"1000025000000250000002500000025000000250000002500000025000000257",
    b"1000067002000670020006700200067002000670020006700200067002000677",
    b"1000567002005670020056700200567002005670020056700200567002005671",
    b"1000000000000000000000000000000000000000000000000000000000000002",
    b"1000888800000000000000000000000000000000000000000000000000000003",
    b"5000080000000000000000000000000000000000000000000000000000000004",
    b"4000003000000030000000300000003000000030000000300000003000000035",
    b"3000004000000040000000400000004000000040000000400000004000000046",
    b"2000025000000250000002500000025000000250000002500000025000000257",
    b"2000025000000250000002500000025000000250000002500000025000000257",
    b"2000025000000257200002500000025000000250000002572000025000000257",
    b"7000000000000002700000000000000000000000000000027000000000000002",
    b"6000000000000000000000000000000000000000000000000000000000000003",
    b"5000000000000000000000000000000000000000000000000000000000000004",
    b"4000003000000030000000300000003000000030000000300000003000000035",
    b"3000004000000040000000400000004000000040000000400000004000000046",
    b"2000025000000250000002500000025000000250000002500000025000000257",
    b"1200067002000670020006700200067002000670020006700200067002000677",
    b"7200567002005670020056700200567002005670020056700200567002005671",
    b"7000000000000000000000000000000000000000000000000000000000000002",
    b"6000000000000000000000000000000000000000000000000000000000000003",
    b"5000000000000000000000000000000000000000000000000000000000000004",
    b"4000003000000030000000300000003540000030000000300000003000000035",
    b"3000004000000040000000400000004630000040000000400000004000000046",
    b"2000025000000257200002500000025720000250000002572000025000000257",
    b"5000000000000000000000000000000450000000000000000000000000000004",
    b"4000003000000030000000300000003540000030000000300000003000000035",
    b"7000000000000002700000000000000270000000000000027000000000000002",
    b"6000000000000003600000000000000360000000000000036000000000000003",
    b"5000000000000004500000000000000450000000000000045000000000000004",
    b"4000003000000030000000300000003000000030000000300000003000000035",
    b"3000004000000040000000400000004000000040000000400000004000000046",
    b"2000025000000250000002500000025000000250000002500000025000000257",
    b"1200067002000670020006700200067002000670020006700200067002000677",
    b"7200567002005670020056700200567002005670020056700200567002005671",
    b"7000000000000000000000000000000000000000000000000000000000000002",
    b"6000000000000000000000000000000000000000000000000000000000000003",
    b"5000000000000000000000000000000000000000000000000000000000000004",
    b"4000003000000030000000300000003000000030000000300000003000000035",
    b"3000004000000040000000400000004000000040000000400000004000000046",
    b"2000025000000250000002500000025000000250000002500000025000000257",
    b"2000025000000250000002500000025000000250000002500000025000000257",
    b"2000025000000257200002500000025000000250000002572000025000000257",
    b"7000000000000002700000000000000000000000000000027000000000000002",
    b"6000000000000000000000000000000000000000000000000000000000000003",
    b"5000000000000000000000000000000000000000000000000000000000000004",
    b"4000003000000030000000300000003000000030000000300000003000000035",
    b"3000004000000040000000400000004000000040000000400000004000000046",
    b"2000025000000250000002500000025000000250000002500000025000000257",
    b"1200067002000670020006700200067002000670020006700200067002000677",
    b"7200567002005670020056700200567002005670020056700200567002005671",
    b"7000000000000000000000000000000000000000000000000000000000000002",
    b"6000000000000000000000000000000000000000000000000000000000000003",
    b"5000000000000000000000000000000000000000000000000000000000000004",
    b"4000003000000030000000300000003540000030000000300000003000000035",
    b"3000004000000040000000400000004630000040000000400000004000000046",
    b"2000025000000257200002500000025720000250000002572000025000000257",
    b"1234567712345677123456771234567712345677123456771234567712345677",
]