[
    b"1234567891111111111111111111111111111111111111111111111111111111",
    b"1000000000000000000000000000000000000000000000000000000000000001",
    b"1000000000000000000000000000000000000000000000000000000000000001",
    b"1000000000000000000000000000000000000000000000000000000000000001",
    b"1000000000000000000000000000000000000000000000000000000000000001",
    b"1000000000000000000000000000000000000000000000000000000000000001",
    b"1000000000000000000000000000000000000000000000000000000000000001",
    b"1000000000000000000000000000000000000000000000000000000000000001",
    b"1000000000000000000000000000000000000000000000000000000000000001",
    b"1000000000000000000000000000000000000000000000000000000000000001",
    b"1000000000000000000000000000000000000000000000000000000000000001",
    b"1000000000000000000000000000000000000000000000000000000000000001",
    b"1000000000000000000000000000000000000000000000000000000000000001",
    b"1000000000000000000000000000000000000000000000000000000000000001",
    b"1000000000000000000000000000000000000000000000000000000000000001",
    b"1000000000000000000000000000000000000000000000000000000000000001",
    b"1000000000000000000000000000000000000000000000000000000000000001",
    b"1000000000000000000000000000000000000000000000000000000000000001",
    b"1000000000000000000000000000000000000000000000000000000000000001",
    b"1000000000000000000000000000000000000000000000000000000000000001",
    b"1000000000000000000000000000000000000000000000000000000000000001",
    b"1000000000000000000000000000000000000000000000000000000000000001",
    b"1000000000000000000000000000000000000000000000000000000000000001",
    b"1000000000000000000000000000000000000000000000000000000000000001",
    b"1000000000000000000000000000000000000000000000000000000000000001",
    b"1000000000000000000000000000000000000000000000000000000000000001",
    b"1000000000000000000000000000000000000000000000000000000000000001",
    b"1000000000000000000000000000000000000000000000000000000000000001",
    b"1000000000000000000000000000000000000000000000000000000000000001",
    b"1000000000000000000000000000000000000000000000000000000000000001",
    b"1000000000000000000000000000000000000000000000000000000000000001",
    b"1000000000000000000000000000000000000000000000000000000000000001",
    b"1000000000000000000000000000000000000000000000000000000000000001",
    b"1000000000000000000000000000000000000000000000000000000000000001",
    b"1000000000000000000000000000000000000000000000000000000000000001",
    b"1000000000000000000000000000000000000000000000000000000000000001",
    b"1000000000000000000000000000000000000000000000000000000000000001",
    b"1000000000000000000000000000000000000000000000000000000000000001",
    b"1000000000000000000000000000000000000000000000000000000000000001",
    b"1000000000000000000000000000000000000000000000000000000000000001",
    b"1000000000000000000000000000000000000000000000000000000000000001",
    b"1000000000000000000000000000000000000000000000000000000000000001",
    b"1000000000000000000000000000000000000000000000000000000000000001",
    b"1000000000000000000000000000000000000000000000000000000000000001",
    b"1000000000000000000000000000000000000000000000000000000000000001",
    b"1000000000000000000000000000000000000000000000000000000000000001",
    b"1000000000000000000000000000000000000000000000000000000000000001",
    b"1000000000000000000000000000000000000000000000000000000000000001",
    b"1000000000000000000000000000000000000000000000000000000000000001",
    b"1000000000000000000000000000000000000000000000000000000000000001",
    b"1000000000000000000000000000000000000000000000000000000000000001",
    b"1000000000000000000000000000000000000000000000000000000000000001",
    b"1000000000000000000000000000000000000000000000000000000000000001",
    b"1000000000000000000000000000000000000000000000000000000000000001",
    b"1000000000000000000000000000000000000000000000000000000000000001",
    b"1000000000000000000000000000000000000000000000000000000000000001",
    b"1000000000000000000000000000000000000000000000000000000000000001",
    b"1000000000000000000000000000000000000000000000000000000000000001",
    b"1000000000000000000000000000000000000000000000000000000000000001",
    b"1000000000000000000000000000000000000000000000000000000000000001",
    b"1000000000000000000000000000000000000000000000000000000000000001",
    b"1000000000000000000000000000000000000000000000000000000000000001",
    b"1000000000000000000000000000000000000000000000000000000000000001",
    b"1111111111111111111111111111111111111111111111111111111111111111",
]